XXXXXXXXXX
XXXXXXXXXX
XXXXXXXXXX
XXXXXXXXXX
XXXXXXXXXX
XXXXXXXXXX
OOXXXXXOXX
XXXXXXXXXX
XPXXXOXXXX
XXXXXXXXXX
